{
  "rows": 10,
  "columns": 10,
  "map": [
	[2,2,2,2,2,2,2,2,2,2],
	[2,2,2,1,1,1,1,2,2,2],
	[2,2,1,0,0,0,0,1,2,2],
	[2,1,0,0,0,0,0,0,1,2],
	[2,1,0,0,5,5,0,0,1,2],
	[2,1,0,0,5,5,0,0,1,2],
	[2,1,0,0,[3, 3],[4, 1],0,0,1,2],
	[2,2,1,0,[3, 3],0,[4, 2],1,2,2],
	[2,2,2,1,1,1,1,2,2,2],
	[2,2,2,2,2,2,2,2,2,2]
   ],
}